11111111111111111111111111111111
13333333333100010000000010000001
13333333333100010000000010000001
13313133333100010000000010000001
13313133333100010000000011100111
13311133333100010000000000000001
13333333333100010000000000000001
13333333333100010000000000000001
11113333111100010000000000000001
10000000000000000000000000000001
10000000000000000000000000000001
11112222111100011111111111100001
12222222222100014444444444444441
12222222222100014444444444444441
12222222222100014444444444444441
12222222222100014444444444444441
12222222222100014444444444444441
12222222222100014444444444444441
12222222222100014444444444444441
11111111111111111111111111111111