11111111111111111111111111111111
13333333333100010000000000000001
13333333333100010000000000000001
13313133333100010000000000000001
13313133333100010000000000001001
13311133333100010000000000010001
13333133333100010000000000100001
13333313333100010000000001000001
13333331333100000000000010000001
10000000101000000000000100000001
10000000000000000000001000000001
12222222222100011111111111111001
12222222222100014444444444444441
12222222222100014444444444444441
12222222222100014444444444444441
12222222222100014444444444444441
12222222222100014444444444444441
12222222222100014444444444444441
12222222222100014444444444444441
11111111111111111111111111111111