11111111111111111111111111111111
10000000000100010000000000000001
10000000000100010000000000000001
10010100000100010000000000000001
10010100000100010000000000001001
10011100000100010000000000010001
10000100000100010000000000100001
10000010000100010000000001000001
10000001000100000000000010000001
10000000101000000000000100000001
10000000000000000000001000000001
10000000000100010000010000000001
10000000000100010000100000000001
10000000000100010001000000000001
10000000000100010010000000000001
10000000000100010100000000000001
10000000000100011000000000000001
10000000000100010000000000000001
10000000000100010000000000000001
11111111111111111111111111111111