11111111111111111111111111111111
10000000000100010000000000000001
10000000000100010000000000000001
10000000000100010000000000000001
10000000000100010000000000000001
10000000000100010000000000000001
10000000000100010000000000000001
10000000000100010000000000000001
10000000000000000000000000000001
10000000000000000000000000000001
10000000000000000000000000000001
10000000000100010000000000000001
10000000000100010000000000000001
10000000000100010000000000000001
10000000000100010000000000000001
10000000000100010000000000000001
10000000000100010000000000000001
10000000000100010000000000000001
10000000000100010000000000000001
11111111111111111111111111111111